BBBBBBBBBBBBBBBBBBBBBBBBBBBBBBBBBBBBBBBBBBBBBBBBBBBBBBBBBBBBBBBBBBBBBBBBBBBBBBBBBBBBBBBBBBBBBBBBBBBBBBBBBBBBBBBBBBBBBBBBBBBBBBBBBBBBBBBBBBBBBBBBBBBBBBBBBBBBBBBBBBBBBBBBBBBBBBBBBBBBBBBBBBBBBBBBBBBBBBBBBBBBBBBBBBBBBBBBBBBBBB
B                                                                                                                                                   B                                                                        B
B                                                                                                                                                   B                                                                        B
B                                                                                                                                                   B                                                                        B
B                                                                                                                                                   B                                                                        B
B                                                                                                                                                                                                                            B
B                                                                                                                                                                                                                            B
B                                                                                                                                                   B                                                                        B
B                                                                                                                                                   B                                                                        B
B                                                                                               C                                       BB          B                                                                        B
B                                                                                                                          BB                       B                                                                        B
B                                                                   C                                     BB                                        B                                                                        B
B                                                                                             BB                                                    B                                          C C C C C C C C C C C C       B
B                                                                                                                                                   B                                                                        B
B                                                                             BB                                                                    B                                                                        B
B                                                                                                                                                   B                                                  E                     B
B                                                                   BBBB                                                                            B                                                 BBB                    B
B                                                                                                                                                   B                                                                        B
B                                                                                                                                                   B                                                                        B
B                                        CCC                                                                                                        B             BBB                                         BB      B      B
B                                                                                                                                                   B                                                                        B
B                                                                                                                                                   B                                                                        B
B                                       BBBBB                                                                                                       B                                                             BB         B
B                                                                                                                                                   B                      BBBB                                              B
B                                                                                                                                                   B                                                                        B
B                                                                                                                                                   B                                                    BBBB                B
B                                                                                                                                                                                                                            B
B                               E                                                                                                                                                                                            B
GGGGGGGGGGGGGGGGGGGGGGGGGGGGGGGGGGGGGGGGGGGGGGGGGGGGGGGGGGGGGGGGGGGGGGGGGGGGGGGGGGGGGGGGGGGGGGGGGGGGGGGGGGGGGGGGGGGGGGGGGGGGGGGGGGGGGGGGGGGGGGGGGGGGGGGGGGGGGGGGGGGGGGGGGGGGGGGGGGGGGGGGGGGGGGGGGGGGGGGGGGGGGGGGGGGGGGGGGGGGGG