BBBBBBBBBBBBBBBBBBBBBBBBBBBBBBBBBBBBB
B                                   B
B                                   B
B                                   B
B                                   B
B                                   B
B                                   B
B                                   B
B                                   B
B                                   B
B                                   B
B                                   B
B                                   B
B      C C C C C C C C C C C C      B
B                                   B
B                                   B
B              E                    B
B             BBB                   B
B                                   B
B                                   B
B                     BB       B    B
B                                   B
B                                   B
B                          BB       B
B                                   B
B                                   B
B                BBBB               B
B                                   B
B                                   B
GGGGGGGGGGGGGGGGGGGGGGGGGGGGGGGGGGGGG